###############
#P XX X  X   P#
# # #X#X# #X# #
#X   XXX X  X #
# # #X# #X#X# #
#       XX    #
# # # # #X# # #
#    XX   XX  #
# #X# # #X# # #
#    X XX X   #
#X# #X# # # # #
# X  XX  X XX #
# # # # #X# # #
#P XX   XX  P #
###############