#################################################################
#                                                               #
#                                                               #
#                         ! ! ! ! ! !                           #
#                                                               #
#                          ! ! ! ! !                            #
#                                                               #
#                           ! ! ! !                             #
#                                                               #
#                            ! ! !                              #
#     P                                                         #
#                              !                                #
#                                                               #
#                            ! ! !                              #
#                                                               #
#                           ! ! ! !                             #
#                                                               #
#                          ! ! ! ! !                            #
#                                                               #
#                         ! ! ! ! ! !                           #
#                                                               #
#################################################################