*XX*****XXXX*X*
*XX*XXX***X****
***XXX*******X*
*****X**X*XX***
*XXXXXX**X***X*
****X**XX**X*XX
X*XXX*X*X***XX*
***X********XX*
X*XX****XX*****
*****X*X*X*X*XX
XX*X*X*X**XXXXX
X****X*XXXXXX*X
**XXX*X****XX*X
X*****XX*XX****
*XXXXX*X***X**X
